█████████████████████████████████████████▓████████████▓█▓███████████████░░    ░▓▒██████████████████▓▓ ░██▓▓▒░█▒▓█████████████████████▓████████████████████████████████████████████████████████▒██▓█▓█████████████▓░▒██████▓█▒█████████▓▒▓█  ▒▒                 ░██████████████████████████████          ░███
██████████████████████████████████████████▓░░▒▒▒▒░░  ░░░▒███████▓█████░ ▒    ░████████████████████▓▓█  ░▒█████▓▓████████████░░▓▒░▓███████▓██████████████████████████████████████████████████████▓░░▒████████████████████▓██▓█▒    ██████▓▓░                     ░█████████████████████████████████▒   ░█████
██████████████████████████████████████████▓█▓▒░░    ░▓▒▒████████████░       ░████████████████████░ ▒███▓  ██▓░████████▓▒░░  ▒░▒▓█▓▓▓▒▒▓███░     ░░░░░░    ████████████████████░▒█████████████▓███▒ ░▓█████████████████████▓░░       █████████                    ▓██████████████████████████████████████████
█████████████████████████████████████████▓▒ ░▒▒░  ░  ░░▒██████▓  ░▓░        ▒███████████████▓ ▒█████░   ▓██▓▒▒▒████░▒██▓▒▓▒   ▒▒                ░        ▒▓          ▒████████████████████ ░▒▒   ▓▒█████████████████████████▓             ░                      ▒███████████████████████████████████▓██████
█████████████████████████████████████████▒ ░         ░████████             ▒▓████████████      ▒███████    ▒█████░    █████▒▒▒           ▓████████████████▒             ░▒███████▓▓██████▒   ░████████        ▓███████████████▓                                   ▒██████████████████████████████████▒▓█████
███████████████████████████████████████▓▓▓▒░  ░░▓██▒██████████▒  █░      ░█▓████████▒  ░▒░░    ░░█████████▒░ ░░     ░░░▓██▓░        ▒████░                ░ ▒▓▓███▒        ███▓▒▒░░▒▒▒▒▒██▓░█████████   ░ ░██░   ███████████▒███▒                               ░ ▓█████████████████████████████████████████
█████████████████████████████████████████████████▓▓▒░ ██████████   ░█░   █▓████████░▒  ▒ █░    ▒▒▓███▒███       ░▒▓▒     ▒░░   ▒█░        ▒▒▓▓▓▓███████████         ▓██▓▒▒ ░▒   ▒▒▒▓█▒       ███████   ▓██   █   ▒███████████▓░█▒              ░               █▓░██████████████████████████████████████████
████████████████████████████████████████████████████████████░▒█     ░ ░ ▒██████████ ░▒  ░   █ ▒▒▒██▓▒    ████  ░░░      ▓██▒░      ░▓█████████████████████████████▒       ▓██       ░   ░███░   ████  █▓ ████    ░█████████████▓█▓           ░▒█▒███████████████████████████████████████████████████████████
███████████████████████████████▒██████▒        ░█▓▒███░░░            ▒ ▒███████████  ░▓  ░    █░▓██        ███▒     ███░      ▒█████████▓▓▓▓███████████████▓▓▓█████████▓    █████▓     ███░       ██▒   █        ███████████████▒▓▒               ▓████████▒▒░▓██████▒▓█████████████████████████████████████
████████████████████████████████▓▒▓█▓░              ██                ██████████████░  ░▒   ██▓██▒           █▒   ▒▓░    ▒████████▓▓█████████████████████████████████████████   ▓████░██            █▒░         ░█████████████████▒                            ▓▓▒██████▓████████░▒▓████████████████████████
██████████████████████████▓██████▓▒▓░░              ██████           ░█████████████▓▒█▓░    ████░            ░        ▓█████▓▒▒▒███████████████████████████████████████▒▒▓████▒   ▓█▓  ▒             ░███▓▓▓████ █████▒  ░████████▓            ▒███             ▒░░█████▓░▒▓███████▓████████████████████████
██████████████████████████████████▓▓░      ▒░      ▒██████████▒      ▓████████████ ████████████               ░▒▒   ███████████████████████████████████████████████████████▓█████    ██                ██████████▓██░     ░████████       ▒████████             ░██▒▒████▓██▒▓██░▒▒█████████████████████████
███████████████████████████████▓▓▒░  ░░            ████▒     ░ ███░  ████▓    ░   ▓██████████                ▒█  ░▓███████████████████████▓░░          ░▒▒█████████████████████████    ██                █████▒░█▒           ░█████  ▒███       ███              ░░██▓▒▒░░░▒  █▓▓░ ▒████████████████████████
████████████████████████████████▓▓▓▓              ░███         ▒▒███████▒▒▒         ████████                █   ░███████████████▒▓█▓░                          ░▒███████████████▓██▓█▒   ▓█░   ░          ██████              ▓████████░▒        ███                      █    ▓▓███████████████████████████
▓███████████████████████████████▒██▓░   ░   ▒     ███          ░▓██████▓             ███████▒    ▒▒       ▒    █████████████▓▓▓                                     ░████████████████▓██░  ▒█      ▒     ▓▓██▓██    ░          █████████▓         ███                     ░▒░▒██████████████████████████████
▒▓███████████████████████████▓▓█▓██▒   ▒▒   ░▒▒   ██▒          ▒███▒▓▓▒    ▓██▒   ░  ████▒   ░█▒        █    ████████████▒▓          ░▓█▓▓░  █▓▓▓▓▒▒▒▓▓██░  ▒           ░▒███████████▓▓██▓   █▒      ▓█░    ▒███               █████████▓          ██            ░   ░██████████████████████████████████████
████████████████████▓▓▓████████▓▓███▓▒       ░▓░ ▓█▒          ░██▓  ░ ▒▓ ░           ▓██  ░     ▒░     ▓   ░██████████▓░▓░            ▒████▒████████████▓██████░           ░████████████▓██▒        █▓       █▓               ░▒█████████          ██        ░  ▓▓█▒ ▒██████████████████████████████████████
█████████████████████▓█████████████████████▓▓▒▒▒░██           ███░▒░ ░▒▓░          ░██▓▒             █    ██████████▒             █████████████████████████████████░           ░████████▓▓███   ▓              ▒▒░           ▓███  ░█████           ██▒ ▓███████████████████████████████████████████████████
█████████████████████▓█████████▒██████████████▓███░          ▒█▒░    ░░░▒░        ░███   ▒░             ██████████▓           ░█████████                     ▒█████████        ░▒██████████▒▓█                 ░███▒           ██░  ░████            ███████████████████████████████████████████████████████
█████████████████████████████████▓░ ▒▓▒▒▒░     ░██           ▓░ ░    ░         ░▓████▒          ▓░     ███████████░         ▒ ████▓▒                               ████   ▒▒▒     ██████████▓▒▓░  ░▒██░         ▒██▓ ██▓██      ▒█░ ░▓██▒▓           ███▒▓  ░  ▒▓░  ▓▓█████████████████████████████████████▓
███████████████████▓▓▓█▓███████████▒░          ██            ░                         ░░             █████████░░         ▓███               ▓▓▓▒▒▓▓▓▒▒▓▓               ████▓▓▒    ░█████████▓▓█▒    ░▓                          ░▒  ▒███▓░          ▒██▒         ░░▓█████████████████████████████████████░ 
████████████████████████████████████▓░         ██                                              ▒    ▒█████████        ░▓▓███             ▒▓█▒███████████▒▒████▓▓▒░       ░███▒▒▒     ▓█████████▓█▒     ▒█▒                          ░ ▒███░           ██▓        ░░ ▓███████████████████████████████████▒░  
██████████████████████████████▓▒▒░░▓▒░        ▒█░                                                  ░█████████        ▓▓▒█▓       ▒█████████░             ░▓███████▓░ ░      ████▒░     ███████████▒     ▒                              ░██░           ██     ▒▓░ ░██████████████████████████████████████▒▒▒░
█████████████████████████▒░░                  ▒▓                                                  ▓████████▓       █▓███      ░ █▓███▓░                         ▓████░       ░████      ████████▓▓▓░                                    ▒█▓            █▒     ▓░  ░▒███████████████████████████████████▓▓░ ░
░ ░▒▓██████████████████▓░░▒░░  ░░              ▒                                                 ▒█████████        ██░       ▓█               ▒▒▓▒█▓▒░                 ██▒      ███      ███████████▓                                   ░▒▒            ██░      ░█████████▒  ▓████████████████████████▓█████
▒▒▒▒██████████████████████▓▓█▓▓██▒                                                               ▒▓███████░       ▒▒       ▒██░        ▒███████▓▒██▓ ▒ ░▒▓▓▓░          ▒███      ▒ █░     █████████▒▓▒                                                 ███▓▒▒▒████████████▓▓▓█████████████████████████▓▓████
        ▓██████████████████████████            █▓░                                          ░   ░▒███████▒      ██       ███       ▒█████▒▒▓▒█▓▒▒  ░░    ▓     ░         ▒███░   ░ ██▓░    ████████▓▒▒                                           ▓▓██████▒▓█      ▒███████▓█████████████████████████████████
  ░░   ░ ██████████████████████████▒       ▒ ░  ░                                           ░   ░▒██████       ▓▓░    ░▓██░     ░▓██▒▒▓▒▒▒▒▒ █▒█▒░░▒░░░  ░         ▒███    ▒██▓     ███    ░███████▓░░▒                                               ██████████████████████████████████████████████████████
▒░░  ░▒▒   ▓███████████████████████        ░                                                    ░▓█████▒░     ▓██     ▒ ░    ░██▓▓██▓███████▓██▒▒▒░▒▒░▒▒██▓░           ▒█    ░▒▒     ██▒░   ▓███████░ ▒                                                      ░░▒████████████████████████████████████████████
█▒░░░██░▓█▓░░▒░ ▓███████████████████                                                            ▒▓▓██▓▓ ░    ░██           ░█▓░░░▓▓███▓▓░    ▒▒▒▓████░░     ░░ ░██       ██          ▒██▒    ▓█████▓▓▒                                                         ▒▒▓██████████████████████████████████████████
██████████████▓██████████████████████████▒                                                      ▒▒▒███▒░     ░█░   ░▓    ░▓██▓▓▓▒█▒▒▓░  ▒▓█▓░░░░▒▒▒▒▓▓▓▒░  ░░   ███░   ░▒███░   ░▒░   ██▓    ▒▓████ ▒░                                  ░ ▒                  ░  ░▓██████████████████████████████████████████
███▓▓███████████████████████████████████░                                                       ▒▒▒███      ░█▓   ░█░   ░▒░░▒███▓░   ▓▒ ░▒███▓▒ ░░░   ░░░▒▓███▒░   ▓▓░███▓▒██    ██    ██     ░████▒▓▒                                                      ▒▓▒▒▒▓██████████████████████████████████████████
████████████▓▓████████████████████████░                                                         ▓▒▓▓▓░      ░▒   ░█░    ░░▒░▒▓▓░▒  ░▓███▒░░░░░░░ ░░   ░░ ░░▒░ ░▓▓▓░   ▒     ▒     ██   ▓█      ▓█▒█▓▒                                                  ▓   ░▒▒▒▒▒▓██████████████████████████████████████████
███████████████████████████████████████████████░                                        ░      ▒▓▓▒  ░▒      ░   ▓█     ░ ░░▒░   ░███░░░░ ░▒▓▓▒▒▓▓▓▓▓▓▒░░▒▒▒▒  ▒░▒██▒  ▒           ▓▒          ▓   ▒▒░                                            ░ ▓███████████████████████████████████████████████████████
██████████████████████████████████████████████████▓░                                           ░▒▒▒  ░░          █   ░▓▓▒▒░    ▒▓▓░ ░ ░▓░░▒▒▓█▓▒▓█▓░  ░░░▒▒▒▒  ▒░░░▒▒▒         ▒               ▒░ ▓▓▒▒                                               ▒██████████████████████████████████████████████████████
██████████████████████████████████▒    ▓▒░░                                     ░░░         █    ░█▓▓                  ▒░     ▓▒  ░░  ░▒██████████▓▓ ░█░  █  ░░░  ░░  ▒░   ▒                   ░▓██▒░   █                                             ██░█████░░▒▒▓  ▓██████████████████████████████████████
███████████████████████████████████     ░░                                                    █   ███░▒                      ▒ ░   ░░███████████████▒▓▓  ▒█▒     ░                            ░░▓██░                                 ░     ░           ░ ░█▓▒▓    ░░░▓██████████████████████████████████████
████████████████████████████████████   ░                                                    ░  ██  ▓▓▒                      ░     ░▓███████▒▓███▓▒  ░▒█████▓  ░                               ░▒▓▒▒ ░█                                     ░          ░▒  ░ ▓█   ▒▓█▓▓██░███████████████████████████████████
█████████████████████████████████████▓ ░                                                        █░░░░                            ▒▒▒▓▓▓███▓▒▒▒░░▒█▒▒ ░       ▓██▒░▒                             ░  ░▒                                   ▒▓▓            ██▒▒ ░█   ▓█▓   ░░███████████████████████████████████
██████████████████████████████████▒░▓▒    ▒░                                                    ▒ ░█▓                           ▒█▓██▓████▓▒▓▒░░▒▒▒▒▒ ░ ▒       ▓▓                              ░▒░░░                                   ▓▓▓█           ████▒▓██  ▒▓▒▒▒▒░▒███████████████████████████████████
███████████████████████████████████▒ ░                    ░      ▒░                             ▓ ░█▓                         ░░░▒▒▓██▓▓▒▒▓▒▒▒▒▓▓▓███▓▒▒ ░░░    ▓█▓▒                             ▓█▓▒                                    ░░           █████████      ░▒▓████████████████████████████████████
██████████████████████████████████████▒▒░                 ░▓▓▒  ░              ████ ░           ░ ▓█▓                         ░░░▒▓▓▒▓▒░░▓▓██▓▒▒▒▒▒▒▒▒▒▒▒▓▒░░░▒▒░▒▒▒░                            ▓▓▓▒░   ▓                      ▒█     █▓▒█▓     ▒▓   █████████░  ▓█████████████████████████████████████████
███████████████████████████████████▓█▓█▓                          ░           ████▓        ░    ░ ▓█▓                          ░▒▒░▒░ ░▓▓▓▓▒▒▒▒▒▒░▒▒▒░░░░░░     ░░░ ░                           ▒██▓░▒   ▓           ██                █▒  ▒     ▓▒░  ██████████▓███████████████████████████████████████████
███████████████████████████████████▓▓▒██▓   ▒░                ▒█░▓██░  ▓█    █████         ░    ░░▓██░░                           ░  ▒▒▒▒▒░▒▒▒▓▓▓▓▓░   ░░                                       ▒██▓░░   ▓         ▓█▓██     █   ░█░  ███▓██▒   █▓▒░░▒█████████▓ ▒▓▒▒███████████████████████████████████████
██████████████████████████████████████████████▓███████▓ ▓█░░▒░███▓         ▓████              ░ ░▒███▓░                             ░   ░▒░▓█▒   ░░░        ░                                  ░ ██▓▒    █         ▓▓▓████▓    ███  ░███▓███████████████████████████████████████████████████████████████████
██████████████████████████████████████████████████████████ ░░ █░████▒  ░███████            ███   ▓▓██▓▒                                ░▒▒▒░░▒░ ░▒░░   ░                                       ▒░█▒█   █▓█             ▒██████▓░░▒██████ █ ░██               ▒░▒████████████████████████████████████████████
███████████████████████████████████▓▓▓ ▒█████           ██  ▒░███████  ███████             ▓  ██  ▒██▓▒                               ░░░    ░░ ░░░░░▒░                                        ▒▒██  ██  ▓               ▒██████ ░███▓█▒ ▓ ▒▓              █▓▓▒▓████████████████████████████████████████████
██████████████████████████████████▒░▒░   ▓██▒▒░         ▓▓█▒▓ ██▓██████████▒ ░             █   ▓█░ ▒▓▒                                     ░░░░░░░░░░░░                                        ▓▒▒░ █▓   ▓                 ██████████░█▒▒████        ▒▒░▒██▓▓█▓███████████████████▓▓▓███████████████████████
██████████████████████████████████▓██▒   ███▒▒▒▒░       █████▓▒█████▓░█▒░░   ░             █    █████▓▒                                     ░ ░ ░░░░░░░░                                        ▒██▓▓▒   █░                ░░▓██░▒█████▓░█▒ ▒     ░▒      ▒██████████████████░░▒ ░▓█████████████████████████
██████████████████████████████████▓███▒ ░█████░   ▓▒▒   █▓▓██ ▒████       █▒░▒░  ▒         █    ▒████   ▒██                                                                                █   █▒███▓█   █░        ▒▒      ▒      █████████▒▓    ▒▒░▒████ ████████████████▓▒▓███▒███████████████████████████
██████████████████████████████████████▓░███████▓▒░  ░  ░█████▒██▓                          █  ░░▒████     ░█░                                                                             ▓     ░███▓█   █         █████░    ▒█░ ▒▒▒███████▓█░    ▒░░   ░▒██████████████████████████████████████████████████
████████████████████████████████████████████████▓▓▒▒▒  ▓████▒▓████▓███           ░         ▓  ▒▒▓████▒░       ░                                                                           ░     ▒█████   █         ▓▓░░    ▒▒░     ▓▓████████▒  ██▓  ▒▓█████████████████████████████████████████████████████
███████████████████████████████████████████████████▓█  ███████████░▓▒▒██░                  █  ▓▓█████▒▒                                                                                   ░    ░▒█████   █▒        ▒  ░█▓░▒        ███▓███████     ███▓▓████████████████████████████████████████████████████
████████████████████████████████████████████████████▓ ░████████▓██████      ▒███████░  ▒▒ ░█   ▓███████                                                                                        ███████░  ░█        █▓███▓▓    ▒█████████ █████  █████░░▒▓███████████████████████████████████████████████████
█████████████████████████████████████████████████████▓▓██████████████ ▒█  ░▒███████▒░░▒██  █    ▒██████   █                                                                                ░   █████░    ██  ░    ▓███████▒ ░███████████▒█████ █▒▓░  ▒██████████████████████████████████████████████████████
███████████████████████████████████████████████████████████████████▓▓███▓▒▓████████▒▓▓▒▓  ░█▓███▓█████▓  ▒▓          ░                                                                     ▓  ░█████████░█▒ ▓█▓▓▒░███████████████▒██████████████████████████████████████████████████████████████████████████
███████████████████████████████████████████████████████████████████████▓███████████▒▓██░   ░  ▒████████░ ▓▓░  ▒        ░░                                                                  ▓  ▒███████   ░▒ █▒▒▒  ██████████████████████████████░███████████████████████████████████████████████████████████
███████████████████████████████████████▒░            ▒█████████████████████████████░▓▓▓█▒ ░▒ ░██████████▒▓▓▓ ░▓▒        ▒░                                                ░       ░░   ░   ▓▒█▒███████▒  ░█ ▒▒▒▓▓██████▒░▓████████████████████     ░  ▓█████████████████████████████████████████████████████
███████████████████████████████████████████████████████████████████████████████████░░     ▒▒  ████████████▓█ ▒█▓     ▒  ▒░ ░                                              ░       ▒░  ▒▒░ ▓███████████    █ ██▓▓▒▓████████████████████████████   ▒▓▓████████████████████████████████████████████████████████
███████████████████████████████████████████████████████████████████████████████████     ░░██ ░█████████▓████▓▓███▒   ▓▒ ▓▒░▓▒                                             ░       ░  ░▒▓▒ ▓██▒████████▓  ░█ ████▓██████████     ██████████████   ▒███▓▓███████▓▓█▒ ▒████████████████████████████████████████
████████████████████████████████████████████████████▓▒████████████████▒▒███████████ ░▓▓█▓ ██  ▓██████▒█░ ███░███▓▒░  █▓▒██▓█▓▒░ ░                                ░░ ░░▒▓▒▒▓░ ░░   ▓░  ▒██░▒█▓ ██▓████▓░  ▓█ ████████████     █████████████████  ▓█████████████▓▓▓███████████████████████████████████████████
████████████████████████████████████████████████████▓▓████████▓██████▓▓▒▓  ▓███████▒░  ░░░███████████▒█░ ▒▓     ▒░  ▒▓▓██████▓▒ ▒▒░░░░                  ░░  ░  ░▒▒░░▒▓▓▓▓▒▓▒      ▓█░         ▓████████████ ██ ░▓██████░██▓▒██████████████████▒▒████████████████████████████████████████████████████████████
█████████████████████████████████████████████████████▓█████████████▒▓██▒░▒▒ █████████▓▒▒▒░█▒▒██████████▓▓███▓███▓█▒ ███████████▒▓▓▓▒▒▒░              ░░░░░░ ░ ░░▒▒▒░▒▓▓█▓▒██▓▓▒   ▓█▒ ░▓▒▓▓█▓▒█████████▒ ▒█░▒░▒███████████▓█████████████████████████████████████████████████████████████████████████████████
█████████████████████████████████████████████▓██████████████████████████▓▓██▓██████▓▓██▓▓░█▓░███████████▓███▓█████▒░███████████▒██▓▒▓▒░░            ░░░░░░░░░░▒▒▓▓▒▒█████▓██▓█▓ ░ ██  ▒▓▓██▓█▒█████████▓░▒█▒████████████▓▒█████████████████████▒████████████████████████████████████████████████████████████
████████████████████████████████████████████████████▓██████████████████████▓█▓░▒██████▓▒▓░█▓ █████████████████████▓░▓██████████▓███▒▓▒▒▒░ ░░░  ░        ░░░░  ▒▓▓█▒▒████████▓▓▒░▒░███ ▒█████████████████ ▒█ ███████████████████████████████████▓████████████████████████████████████████████████████████████
██████████████████████████████████████████████████████████████████████▓▒█████████████████▓██▒█████████████████████▓▓███████████▓█████▓▒▓▒░░░░░░░         ░░░░░▓▓█████▓██████▓▓▓▓█████▒██████████████████ ▓█ ███████████████████████████████████▓████████████████████████████████████████████████████████████
███████████████████████████▓▒▒▓█████████████████████████████████████████████████████████████ █████████████████████▓▒▓▓████████████████▒▒▒░░░░░░░     ░░░░░░░▒▒▒█████████████▓▒▒▒▓▒██▒▓██████████████████░▓█▒████████████████████████████████████████████████████████████████████████████████████████████████
████████████████████████████████████████████████████████████████████████████████████████████████████████████████  ▓████████████████▒░░                          ▒▒▒▒▒█████████▓█████▓ ▒▒▓███████████████▓▓█░████████████████████████████████████████████████████████████████████████████████████████████████
█████████████████████████████████████████████████████████████████████████████████████████▓█████████████░░▒▓██████████████████████▓░                                  ███████████████▓▒█████░   ████████████▓████████████████████████████████████████████████████████████████████████████████████████████████
█████████████████████████████████████████████████░   ███████████████████████████████████████████████████████████████████▒▒░▓▒                                            ░░▒██▓████▓░▒█████████████████████▒███████████████████████████████████▒ ▒██████████████████████████████████████████████████████████
████████████████████████████████████████████████████  ██████████████████████████████████████▒░▒███████████████████████████░                                          ░▓██████████▓  ▒█████████████████░  ▓█▓████████████████████████████████████████████████████████████████████████████████████████████████
██████████████████████████████████████████████████████████████████████████████████████████████████████████████████░                                                                ░▓████████████████████████████████████████ ██████████████████████████████████████████████████████████████████████████████
███████████████████████████████████████████████████████████████████████▓████████████████████████████████████████▒                                                                     ██████████████████████████████████████████████████████████████████████████████████████████████████████████████████████
█████████████████████████████████████████████████████████████████████████████████████████████████████████████████                                                                 ▒▓▓███████████████████████████████████████████████████████████████████████████████████████████████████████████████████████
█████████████████████████████████████████████████████████████████████████████████████████████████████████████████                                                                    ███████████████████████████████████████████████████████████████████████████████████████████████████████████████████████
█████████████████████████████████████████████████████████████████████████████████████████████████████████████████░                                                                   ▒██████████████████████████████████████████████████████████████████████████████████████████████████████████████████████
███████████████████████████████████████████████████████████████████████████████████████████████████████████████  ░                                                             ▓███    ▒████████████████████████████████████████████████████████████████████████████████████████████████████████████████████
████████████████████████████████████████████████▒      █████████████████████████████████████████████████████                                                                              ██████████████████████████████████████████████████████████████████████████████████████████████████████████████████
████████████████████████████████████████████████████                ▒████████████████████████████████████▒                                                                                  ████████████████████████████████████████████████████████████████████████████████████████████████████████████████
██████████████████████████████████████████████████████▓░             ▒██████████████████████████████████                                                                                   ░▓███████████████████████████████████████████████████████████████████████████████████████████████████████████████
████████████████████████████████████████████████████████▓         ░▒▓                    ███████▓▓▓▒                                                       ▒░                                    ▓██████████████████████████████████████████████████████████████████████████████████████████████████████████
████████████████████████████████████████████████████████████████▓                      ░                                                                                                                ████████████████████████████████████████████████████████████████████████████████████████████████████
███████████▓▓███████████████████████████████████████████████████████▓▒░░         ░█████▓▓              ████████▓                                                                                          ▓█████████████████████████████████████████████████████████████████████████████████████████████████
██████████████▓▒▒▓█████████████████▓▓▓▒▒▒▓▒█████████████████████████████████████████▓░░▓▓▒███████████████████▒                              ████████████████████▒▒████████████▓▒▓████████▒                           ░▒▓▓██▓▓███████████████████▓▒▒▓████████████████████████████████████████████████████████
█████▓▓▓▓▓███████████▒░▒▒▓█▓░▒▒                     ▒█████████████████████████████████▒                                                                                                                                             ░░▓█▒   ░▒▓█████░         ░░▒▒▒▓▓▓██████████████████████████████████████
██████████░▓█████████████████████████████████▓██████▒▒▓▒     ░███████▓▓▓▓░░                                             ▒                                                                                                                   ░   ░ ░▓█████░   ░     ▒▒▒▒▒▓▓▓▓▓▓▓▒▓▓▓▓████████████▓███▓▓▓▓████
████████████████████████▓▓█▓▒██████████████████████████  ▒█████░                                            ░▒░░░░             ░░░▒░░▒▓▓███████▓█▒░░                    ███                                      ░█░                                  ░▒▒▓████▒  ░░░░░░░░░░░░░░░░▒▒▒▒▒░░░▒▒█████████████████
███▓███████████████░░░░░▒▓███████▓▒░        ▒█████████████▓                                      ░     ▒▓█████████████▒                                                                        ▓▒                   ███░                 ░░░░   ░░░░ ░▒▒░░▒▓▓██████▒  ░         ▒▒▒▒▓███████████████████████
█▒███████████████████████████████████████████░  ▓█████▒   ░ ░░                           ▒▒████▓                                                                                                ██████████████████▓████████████████████▓██████▓▒▓▒░  ░░           ░░▒▒▒░▒▓█▒░░░░▒▒▒▒▒▒▒▒▓▓██████████████████
███████▓░▒░▓██████████████████████████▒     ██████▓▒░     ░    ░   ░▒██▒  ░▒▒▓██▒▓████                                         ░█████████████████████████████████████████████▒   ░░░░░ ░░▓▓▒▓█████████▒                            ▒              ░   ░   ░               ░▒▒▒▒▒▓▓▒▒░░▒▒▒▒▓▓▓▓██████████████
█████████████████████████████████▒░░░░ ░▓██████▓▓▓▓▓▒▓▒▒░▒▓░  ░░▒██▒             █▓             ▓████████████████▒░░                                       ░               ░████▒██████████████████████████████████████████          ░▒▒                ░░░▓██▓▒  ▓██████████████████▓▓▒▓▓▓▓▓▓▓▓▓▓▓█████████
███████████████████████████████████████████▓▓▓▓▒  ░░░▒▒░░░░░░████▓░ ░         ██▒                               ███████▒▒░░▒████▒               ░    ░░░░░░█████████▓░░▓███     ▓▓░░░███▓░                           ░     ░█▓        ░░░▒░              ░▒░▒▒▒▒▓██▓████████████████▓▒▓█████████████████████